00000000000000000000000000000000000000000000000000000000000000000000000000
00000000000000000000000000000000000000000000000000000000000000000000000000
00000000000000000222000000000000000000000000000000000000000000000000000000
00000000000000000010000000000000000000000000000000000000000000000000000000
00000000000000000000000022222222200000000000000000000222000000022222000000
00000000000002200002200000111111122222222200000000000020000000001100000000
00000000000001000000000000000011111111111122222222000000002222000000000000
22200000000000000000000000000111111111111111111111000000000111000000000000
11122220000000000000000000022111111111111111111111000000000011100000000000
11111112222222222222222222211111111111111111111111000000000011000000000000
11111111111111111111111111111111111111111111111111000000000010000000000000
11111111111111111111111111111111111111111111111111000000000000000000000000
11111111111111111111111111111111111111111111111111000000000000000000000000